3 7
#######
#wb#.+#
#######
RR
6 6
######
#....#
#wB+.#
#..b.#
#....#
######
URDRRDDLU
3 7
#######
#wbb++#
#######
RR
6 7 
####### 
#..#### 
#.+.+.# 
#.bb#w# 
##....# 
####### 
DLLUDLULUURDRDDLUDRR 
8 9 
######### 
#...#...# 
#..bb.b.# 
#...#w#.# 
#...#b#.# 
#...++++# 
#...#..## 
######### 
ULRURDDDUULLDDD
6 6
######
#+b..#
#.w..#
#....#
#....#
######
UUULLLL
6 6
######
#B+..#
#.b..#
#.w..#
#....#
######
UUULLLL
6 6
######
#....#
#.Bw.#
#....#
#+.b.#
######
L
0 0